1101. 1110. 1001. 1100. 1010. 1010. 1001. 1100. 1001. 1111.
0110. 1000. 0000. 0011. 1100. 1001. 0110. 0011 .0110. 1001.
1100. 0010. 0000. 1000. 0010. 0011. 1110. 1000 .1000. 0011.
0100. 1000. 0000. 0000. 1001. 1110. 1000. 0010 .0001. 1101.
0110. 0011. 0100. 0010. 0000. 1011. 0101. 1100 .0010. 0001.
1100. 1010. 0000. 1000. 0011. 1100. 0011. 0110 .1000. 0001.
0101. 1100. 0010. 0001. 1110. 0011. 1100. 1001. 0101. 0101.
0101. 0100. 1000. 0001. 1110. 1000. 0010. 0010 .0000. 0011.
0100. 0000. 0001. 0101. 1110. 0010. 1010. 1001 .0111. 1101.
0110. 0010. 0010. 0010. 1010. 1010. 1011. 0110 .1010. 0011.
44
